{
  "D": {},
  "G": {},
  "P": {},
  "Q": {},

  "e": {},
  "f": {},
  "g": {},
  "t": {},
  "y": {}
}
